{
    "small": [
        [0, 0, 0, 0, 0],
        [0, 2, 2, 2, 0],
        [0, 2, 1, 2, 0],
        [0, 2, 2, 2, 0],
        [0, 0, 0, 0, 0]
    ],
    "medium": [
        [0, 0, 0, 0, 0, 0, 0, 0, 0, 0],
        [0, 1, 1, 1, 1, 1, 1, 0, 0, 0],
        [0, 2, 3, 4, 1, 1, 0, 1, 1, 0],
        [0, 2, 3, 4, 1, 0, 0, 1, 2, 0],
        [0, 0, 3, 3, 2, 2, 1, 0, 2, 1],
        [0, 0, 0, 1, 1, 1, 1, 0, 1, 1],
        [0, 0, 0, 0, 0, 0, 0, 0, 0, 0],
        [0, 0, 0, 1, 2, 3, 0, 0, 0, 0],
        [0, 0, 0, 0, 3, 4, 2, 2, 1, 1],
        [0, 1, 2, 2, 1, 1, 1, 2, 2, 0]
    ],
    "large": [
        [0, 0, 0, 0, 0, 0, 2, 2, 2, 2, 2, 2, 2, 2, 0, 0, 0, 0, 0, 0],
        [0, 0, 0, 0, 0, 2, 4, 4, 4, 4, 4, 4, 4, 4, 2, 0, 0, 0, 0, 0],
        [0, 0, 0, 0, 2, 4, 6, 6, 6, 6, 6, 6, 6, 6, 4, 2, 0, 0, 0, 0],
        [0, 0, 0, 2, 4, 6, 8, 8, 8, 8, 8, 8, 8, 8, 6, 4, 2, 0, 0, 0],
        [0, 0, 2, 4, 6, 8, 10, 10, 5, 5, 5, 5, 10, 10, 8, 6, 4, 2, 0, 0],
        [0, 0, 2, 4, 6, 8, 10, 12, 5, 14, 14, 5, 12, 10, 8, 6, 4, 2, 0, 0],
        [0, 0, 2, 4, 6, 8, 10, 12, 5, 14, 14, 5, 12, 10, 8, 6, 4, 2, 0, 0],
        [0, 0, 0, 2, 4, 6, 8, 10, 5, 5, 5, 5, 10, 8, 6, 4, 2, 0, 0, 0],
        [0, 0, 0, 0, 2, 4, 6, 8, 10, 12, 12, 10, 8, 6, 4, 2, 0, 0, 0, 0],
        [0, 0, 0, 0, 0, 2, 4, 6, 8, 10, 10, 8, 6, 4, 2, 0, 0, 0, 0, 0],
        [0, 0, 0, 0, 0, 2, 4, 6, 8, 10, 10, 8, 6, 4, 2, 0, 0, 0, 0, 0],
        [0, 0, 0, 0, 0, 2, 4, 6, 5, 5, 5, 5, 6, 4, 2, 0, 0, 0, 0, 0],
        [0, 0, 0, 0, 0, 2, 4, 6, 5, 4, 4, 5, 6, 4, 2, 0, 0, 0, 0, 0],
        [0, 0, 0, 0, 0, 2, 4, 6, 5, 4, 4, 5, 6, 4, 2, 0, 0, 0, 0, 0],
        [0, 0, 0, 0, 0, 2, 4, 6, 5, 5, 5, 5, 6, 4, 2, 0, 0, 0, 0, 0],
        [0, 0, 0, 0, 0, 0, 2, 4, 6, 8, 8, 6, 4, 2, 0, 0, 0, 0, 0, 0],
        [0, 3, 3, 3, 0, 0, 2, 4, 6, 8, 8, 6, 4, 2, 0, 0, 0, 0, 0, 0],
        [0, 3, 6, 3, 0, 0, 2, 4, 6, 6, 6, 6, 4, 2, 0, 0, 0, 0, 0, 0],
        [0, 3, 3, 3, 0, 0, 0, 2, 4, 4, 4, 4, 2, 0, 0, 0, 0, 0, 0, 0],
        [0, 0, 0, 0, 0, 0, 0, 0, 2, 2, 2, 2, 0, 0, 0, 0, 0, 0, 0, 0]
    ]
}
